NO textures/64_north.xpm
SO ./textures/64_south.xpm
WE textures/64_west.xpm
EA textures/64_east.xpm

F 20,50,0
C 25,155,0





    11111111111
    110000001101
    1001000000001
    10000000W0001
    110000010101       1
    101111010001
    111111111111