NO textures/uwu1.xpm
SO ./textures/uwu2.xpm
WE textures/uwu3.xpm
EA textures/uwu4.xpm


C 15,170,1
F 120,17,20

    11111111111111111111111
  11110000000000000000000011
 11011100001111111101111000111
 10000000010000000001000000011
 10000000010000000001000000011
 10000000010000000001000W00011
 10000000011111111111000000011
 10000000000000010100000011101      111
 10110001111001110001111000111      101
 10000000000000000000000010001      111
 100000000000000000000000000011
11000000000000000000000000000011
10000000000000000000000000000001
10000000000000000000000000000001
11000000000000000000000000000011
 100000000000000000000000000011
 10000000111111111110000000001
 10000000100000000010000000001
 11000000111111111110000000001
 10000000000000000000000000001
 10000000000000000000000000001
 10000000000000000000000000001
 11111111111111111111111111111